# A 5 * 5 squared maz with large corridors
11111111111111111111111111111111111111111
10000000000000000000000000000000100000001
10000000000000000000000000000000100000001
10000000000000000000000000000000100000001
10000000000000000000000000000000100000001
10000000000000000000000000000000100000001
10000000000000000000000000000000100000001
10000000000000000000000000000000100000001
11111111111111111111111110003000100000001
10000000000000000000000000000000100000001
10000000000000000000000000000000100000001
10000000000000000000000000000000100000001
10000000000000000000000000000000100000001
10000000000000000000000000000000100000001
10000000000000000000000000000000100000001
10000000000000000000000000000000100000001
10000000111111111111111110000000100000001
10000000100000000000000010000000100000001
10000000100000000000000010000000100000001
10000000100000000000000010000000100000001
10000000100000000000000010000000100000001
10000000100000000000000010000000100000001
10000000100000000000000010000000100000001
10000000100000000000000010000000100000001
10000000100000001000000010000000100000001
10000000100000001000000000000000000000001
10000000100000001000000000000000000000001
10000000100000001000000000000000000000001
10000000100000001000000000000000000000001
10000000100000001000000000000000000000001
10000000100000001000000000000000000000001
10000000100000001000000000000000000000001
10000000100000001000000011111111111111111
10000000100000001000000000000000000000001
10000000100000001000000000000000000000001
10000000100000001000000000000000000000001
10000000100000001000000000000000000000001
10000000100000001000000000000000000000001
10000000100000001000000000000000000000001
10000000100000001000000000000000000000001
11111111111111111111111111111111111111111