# Tiny maze
1111111111111111111111111111111111111111
1000000000100000000000000100000000000001
1000000000100000000000000100000000000001
1000000000100000000000000100000000000001
1000000000100000030000000100000000000001
1000000000100000000000000100000000000001
1000000000100000000000000100000000000001
1000000000100000000000000100000000000001
1000000000100000000000000100000000000001
1000000000000000000000000000000000000001
1000000000000000000000000000000000000001
1000000000100000000000000100000000000001
1000000000100000000000000100000000000001
1000000000100000000000000100000000000001
1000000000100000000000000100000000000001
1111001111100000000000000100000000000001
1000000000111111100111111100000000000001
1000000000100000000000000100000000000001
1000000000100000000000000100000000000001
1000000000100000000000000100000000000001
1000000000100000000000000111111111111111
1000000000100000000000000100000000000001
1000000000100000000000000100000000000001
1000000000100000000000000100000000000001
1000000000100000000000000100100000000001
1000000000100000000000000100100000000001
1000000000100000000000000100100000000001
1000000000111111111111111100100000000001
1000000000100000000000000100100000000001
1000000000100000000000000100100000000001
1000000000100000000001000100100000000001
1000000000100000000001000000100000000001
1000000000100000000001000000100000000001
1000000000100000000001000000100000000001
1000000000100000000001111111100000000001
1000000000100000000000000000100000000001
1000000000000000000000000000100000000001
1000000000000000000000000000100000000001
1000000000000000000000000000100000000041
1111111111111111111111111111111111111111