11111111111111111111111111111111111111111111111111111111111111111111111111111111
10000000000111000000000001000000000000000000000000000000001111111100000000000001
10000000000111000000000001000000000000000000000000000000001111111100000000000001
10003000000111000000000001000000000000000000000000000000001111111100000000000001
10000000000111000000000001000000000000000000000000000000001111111100000000000001
10000000000111000000000001000000000000000000000000000000001111111100000040000001
10000000000111000000000001000000000000000000000000000000001111111100000000000001
10000000000111000000000001000000000000000000000000000000001111111100000000000001
10000000000111000000000001000000000000000000000000000000001111111100000000000001
10000000000111000000000001000000000000000000000000000000001111111100000000000001
10000000000111000000000001000000000000000000000000000000001111111100000000000001
10000000000111000000000001000000000000000000000000000000001111111100000000000001
10000000000111000000000001000000000000000000000000000000001111111100000000000001
10000000000111000000000001000000000000000000000000000000001111111100000000000001
10000000000111000000000001000000000000000000000000000000001111111100000000000001
10000000000111000000000001000000000000000010000000000000001111111100000000000001
10000000000111000000000001000000000000000010000000000000001111111100000000000001
10000000000111000000000001000000000000000010000000000000001111111100000000000001
10000000000111000000000001000000000000000010000000000000001111111100000000000001
10000000000111000000000001000000000000000010000000000000001111111100000000000001
10000000000111000000000001000000000000000010000000000000001111111100000000000001
10000000000111000000000001000000000000000010000000000000001111111100000000000001
10000000000111000000000001000000000000000010000000000000001111111100000000000001
10000000000111000000000001000000000000000010000000000000001111111100000000000001
10000000000111000000000001000000000000000010000000000000001111111100000000000001
10000000000111000000000001000000000000000010000000000000001111111100000000000001
10000000000111000000000001000000000000000010000000000000001111111100000000000001
10000000000111000000000001000000000000000010000000000000001111111100000000000001
10000000000111000000000001000000000000000010000000000000001111111100000000000001
10000000000111000000000001000000000000000010000000000000001111111100000000000001
10000000000111000000000001000000000000000010000000000000001111111100000000000001
10000000000111000000000001000000000000000010000000000000001111111100000000000001
10000000000111000000000001000000000000000010000000000000001111111100000000000001
10000000000111000000000001000000000000000010000000000000001111111100000000000001
10000000000111000000000001000000000000000010000000000000001111111100000000000001
10000000000000000000000001000000000000000010000000000000001111111100000000000001
10000000000000000000000000000000000000000010000000000000001111111100000000000001
10000000000000000000000000000000000000000010000000000000001111111100000000000001
10000000000000000000000000000000000000000010000000000000001111111100000000000001
10000000000000000000000000000000000000000010000000000000001111111100000000000001
10000000000000000000000000000000000000000010000000000000001111111100000000000001
10000000000000000000000000000000000000000010000000000000001111111100000000000001
10000000000000000000000000000000000000000010000000000000001111111100000000000001
10000000000000000000000000000000000000000010000000000000001111111100000000000001
10000000000000000000000000000000000000000010000000000000001111111100000000000001
10000000000000000000000000000000000000000010000000000000001111111100000000000001
10000000000000000000000000000000000000000010000000000000001111111100000000000001
10000000000000000000000000000000000000000010000000000000000001000000000000000001
10000000000000000000000000000000000000000010000000000000000001000000000000000001
10000000000000000000000000000000000000000010000000000000000001000000000000000001
10000000000000000000000000000000000000000010000000000000000001000000000000000001
10000000000000000000000000000000000000000010000000000000000001000000000000000001
10000000000000000000000000000000000000000010000000000000000001000000000000000001
10000000000000000000000000000000000000000010000000000000000001000000000000000001
10000000000000000011111111111111111111111110000000000000000001000000000000000001
10000000000000000000000000000000000000000010000000000000000001000000000000000001
10000000000000000000000000000000000000000010000000000000000001000000000000000001
10000000000000000000000000000000000000000010000000000000000000000000000000000001
10000000000000000000000000000000000000000010000000000000000000000000000000000001
10000000000000000000000000000000000000000010000000000000000000000000000000000001
10000000000000000000000000000000000000000010000000000000000000000000000000000001
10000000000000000000000000000000000000000010000000000000000000000000000000000001
10000000000000000000000000000000000000000010000000000000000000000000000000000001
10000000000000000000000000000000000000000010000000000000000000000000000000000001
10000000000000000000000000000000000000000010000000000000000000000000000000000001
10000000000000000000000000000000000000000010000000000000000000000000000000000001
10000000000000000000000000000000000000000010000000000000000000000000000000000001
10000000000000000000000000000000000000000010000000000000000000000000000000000001
10000000000000000000000000000000000000000010000000000000000000000000000000000001
10000000000000000000000000000000000000000010000000000000000000000000000000000001
10000000000000000000000000000000000000000010000000000000000000000000000000000001
10000000000000000000000000000000000000000010000000000000000001000000000000000001
10000000000000000000000000000000000000000010000000000000000001000000000000000001
10000000000000000000000000000000000000000010000000000000000001000000000000000001
10000000000000000000000000000000000000000010000000000000000001000000000000000001
10000000000000000000000000000000000000000010000000000000000001000000000000000001
10000000000000000000000000000000000000000010000000000000000001000000000000000001
10000000000000000000000000000000000000000010000000000000000001000000000000000001
10000000000000000000000000000000000000000010000000000000000001000000000000000001
11111111111111111111111111111111111111111111111111111111111111111111111111111111